股票代码	companyinfo	code
股票简称	companyinfo	abbreviation	
公司全称	companyinfo	fullname
市场类型	companyinfo	markettype
证券类别	companyinfo	securitiestype
成立日期	companyinfo	foundationdate
上市日期 	companyinfo	listingdate
注册资本	companyinfo	registrationcapital
总经理	companyinfo	manager
法人代表	companyinfo	legalperson
秘书	companyinfo	secretary
注册地址	companyinfo	registrationaddress
办公地址	companyinfo	officeaddress
电话	companyinfo	tel
传真	companyinfo	fax
电子邮箱	companyinfo	email
公司网址	companyinfo	internetsite
所属行业	companyinfo	industry
所属地域	companyinfo	area
所属板块	companyinfo	field
主营业务	companyinfo	business
公司简介	companyinfo	introduction
发行证券	companyinfo	issuesecurities
分红送配	companybonus	-1
高管	companyexecutive	-1
历史行情	companyhistory	-1
收入构成	companyincome	-1
财务指标	companyfinance	-1